┌────────┐
│██ █████│
│████████│
│█ ██ ███│
│████◀███│
│█ █  ███│
│███████ │
│ ███████│
│████ ███│
└────────┘
