┌────────────────────────────────────────────────────────────────────────────────────────────────────┐
│████████████████████████████████████████████████████████████████████████████████████████████████████│
│████████████████████████████████████████████████████████████████████████████████████████████████████│
│█████████████████████████  ██  █████████████████████████████████████████████████████████████████████│
│████████████████████████ ▽█     ████████████████████████████████████████████████████████████████████│
│████████████████████████ ████  █ ███████████████████████████████████████████████████████████████████│
│████████████████████████████ █ █  ██████████████████████████████████████████████████████████████████│
│█████████████████████████    █   █ █████████████████████████████████████████████████████████████████│
│█████████████████████████     █ ██  ████████████████████████████████████████████████████████████████│
│██████████████████████████ ███  █  █ ███████████████████████████████████████████████████████████████│
│███████████████████████████   ███ ██  ██████████████████████████████████████████████████████████████│
│████████████████████████████ ███  █  █ █████████████████████████████████████████████████████████████│
│█████████████████████████████   ███ ██  ████████████████████████████████████████████████████████████│
│██████████████████████████████ ███  █  █ ███████████████████████████████████████████████████████████│
│███████████████████████████████   ███ ██  ██████████████████████████████████████████████████████████│
│████████████████████████████████ ███  █  █ █████████████████████████████████████████████████████████│
│█████████████████████████████████   ███ ██  ████████████████████████████████████████████████████████│
│██████████████████████████████████ ███  █  █ ███████████████████████████████████████████████████████│
│███████████████████████████████████   ███ ██  ██████████████████████████████████████████████████████│
│████████████████████████████████████ ███  █  █ █████████████████████████████████████████████████████│
│█████████████████████████████████████   ███ ██  ████████████████████████████████████████████████████│
│██████████████████████████████████████ ███  █  █ ███████████████████████████████████████████████████│
│███████████████████████████████████████   ███ ██  ██████████████████████████████████████████████████│
│████████████████████████████████████████ ███  █  █ █████████████████████████████████████████████████│
│█████████████████████████████████████████   ███ ██  ████████████████████████████████████████████████│
│██████████████████████████████████████████ ███  █  █ ███████████████████████████████████████████████│
│███████████████████████████████████████████   ███ ██  ██████████████████████████████████████████████│
│████████████████████████████████████████████ ███  █  █ █████████████████████████████████████████████│
│█████████████████████████████████████████████   ███ ██  ████████████████████████████████████████████│
│██████████████████████████████████████████████ ███  █  █ ███████████████████████████████████████████│
│███████████████████████████████████████████████   ███ ██  ██████████████████████████████████████████│
│████████████████████████████████████████████████ ███  █  █ ██  █████████████████████████████████████│
│█████████████████████████████████████████████████   ███ ██  ██  ████████████████████████████████████│
│██████████████████████████████████████████████████ ███  █  ██  ███ █████████████████████████████████│
│████████████████████████████████████████████    ███   ███ ███ ██   █████████████████████████████████│
│███████████████████████████████████████████ ████ ███ ███  █    ███ █████████████████████████████████│
│██████████████████████████████████████████   ████ ███ █ ██████ █  █ ████████████████████████████████│
│██████████████████████████████████████████   ████ █  █████ █  ██ █  ████████████████████████████████│
│███████████████████████████████████████████ ████ ███  █ █ █████  ███████████████████████████████████│
│███████████████████████████████████████████ █ ██████ █     ██ ███ ██████████████████████████████████│
│██████████████████████████████████████████ ███     ██████████  █      ██████████████████████████████│
│██████████████████████████████████████████   ██  ██ █  █ █ █ ███  █ █  █████████████████████████████│
│████████████████████████████████████████  ██ █       █ ███ ██   ████  █ ████████████████████████████│
│███████████████████████████████████████ ██ ██      █  ███ ██ █  ███ ███ ████████████████████████████│
│██████████████████████████████████████ ████ █ █  █ ██      █       ███ █████████████████████████████│
│██████████████████████████████████████ █    █  █ █    ████  ██  █ █  █ █████████████████████████████│
│███████████████████████████████████████ ████    ███ ██ █      █  ████   ████████████████████████████│
│██████████████████████████████████████████ ███ █  █ █   █ ██  ██  ███   ████████████████████████████│
│█████████████████████████████████████████████       ████ ██  █  █ █████ ████████████████████████████│
│█████████████████████████████████████    ██  █  ██    █  █  █  ██ █████ ████████████████████████████│
│████████████████████████████████████ ████ █ ███   █  █   ████ █    ████ ████████████████████████████│
│███████████████████████████████████   ███████   █ █ █     ████ █ ██████ ████████████████████████████│
│███████████████████████████████████ █ ███   █    █  █ ███  █   █  █████ ████████████████████████████│
│█████████████████████████████████████████  █  ██    ████    █ █ █ █████ ████████████████████████████│
│████████████████████████████████████ ████ ██  ███   ██   █████   ██████ ████████████████████████████│
│████████████████████████████████████  ███  █   █    ██ ██████   ███  ██ ████████████████████████████│
│████████████████████████████████████  █ █    █████ ███ ██ █  █   █  ███ ████████████████████████████│
│███████████████████████████████████    █  ███  █    ██ █ ██ ██ ██   ███ ████████████████████████████│
│███████████████████████████████████ █  █   ██ █ █  █ █ █████ █ █████ █ █████████████████████████████│
│███████████████████████████████████████ █ ██ ████  █  ██ █ ██   █  █████████████████████████████████│
│███████████████████████████████████████  █ ████ ██     █ ████ ████ ██ █ ████████████████████████████│
│██████████████████████████████████████ █  █ ██ ████  █  █ ██   ██████   ████████████████████████████│
│████████████████████████████████████ █ ███ ██ ██ ██ ██   ███  ██  ████ █████████████████████████████│
│███████████████████████████████████   █ █     █      █   █       █ █  ██████████████████████████████│
│███████████████████████████████████ █ █ ████     ███  ██     █     █████████████████████████████████│
│█████████████████████████████████████ ██  ███ ██████ ██ █  ██   █   ████████████████████████████████│
│██████████████████████████████████    ███     █         ███ █ ██████████████████████████████████████│
│█████████████████████████████  ████ ██ █████   █ █ ███ █   ██   ████████████████████████████████████│
│████████████████████████████ ██ ██    █  ███   █  ███   █  █████  ██████████████████████████████████│
│███████████████████████████   ████ █  █ █     ███ ████ ██ ██  █   ██████████████████████████████████│
│███████████████████████████ █     █ █ ███  ██  █████ ████ ███ ██ ███████████████████████████████████│
│███████████████████████████████      █    ██  █ ███ ██  ██ █ █  ████████████████████████████████████│
│█████████████████████████████  ██████ █   █  ██    ███ ███   ███████████████████████████████████████│
│██████████████████████████████ ██ █     ██ ███ █  ███ ██ ██ ████████████████████████████████████████│
│██████████████████████████████  █   █       █████ █████ █  █████████████████████████████████████████│
│█████████████████████████████ █ ██  █  ██████ ███  ████ ████████████████████████████████████████████│
│████████████████████████████ ██ █    ████████   ██  ██ █████████████████████████████████████████████│
│████████████████████████████ █  █   ████████████  ██  ██████████████████████████████████████████████│
│█████████████████████████████  █████████████████████████████████████████████████████████████████████│
│██████████████████████████████  ████████████████████████████████████████████████████████████████████│
│████████████████████████████████████████████████████████████████████████████████████████████████████│
│████████████████████████████████████████████████████████████████████████████████████████████████████│
│████████████████████████████████████████████████████████████████████████████████████████████████████│
│████████████████████████████████████████████████████████████████████████████████████████████████████│
│████████████████████████████████████████████████████████████████████████████████████████████████████│
│████████████████████████████████████████████████████████████████████████████████████████████████████│
│████████████████████████████████████████████████████████████████████████████████████████████████████│
│████████████████████████████████████████████████████████████████████████████████████████████████████│
│████████████████████████████████████████████████████████████████████████████████████████████████████│
│████████████████████████████████████████████████████████████████████████████████████████████████████│
│████████████████████████████████████████████████████████████████████████████████████████████████████│
│████████████████████████████████████████████████████████████████████████████████████████████████████│
│████████████████████████████████████████████████████████████████████████████████████████████████████│
│████████████████████████████████████████████████████████████████████████████████████████████████████│
│████████████████████████████████████████████████████████████████████████████████████████████████████│
│████████████████████████████████████████████████████████████████████████████████████████████████████│
│████████████████████████████████████████████████████████████████████████████████████████████████████│
│████████████████████████████████████████████████████████████████████████████████████████████████████│
│████████████████████████████████████████████████████████████████████████████████████████████████████│
│████████████████████████████████████████████████████████████████████████████████████████████████████│
│████████████████████████████████████████████████████████████████████████████████████████████████████│
└────────────────────────────────────────────────────────────────────────────────────────────────────┘
