┌────────────────────────────────────────────────────────────────────────────────────────────────────┐
│████████ ██ ██████ ███████ ██████████████████████████████████████████████████  ████████████████ ████│
│█████████ ███████ ████████████████████████████ ███████ █ ████████████████ ███████████████ ██████████│
│ ███████████ █████████████████████████ ████████████████ █████████████████ ████████████ █████████████│
│ █ ████████ █████ ███████████████████████████ ██ ██████ ███ █████████ ███  ████████████████████ ████│
│███  █████ ███ █ █ █████████████████████ ████████████ █████████████ ██████████████████████ ██████  █│
│██████████ ███  ██████████████████████ ███ ██████████████████ ██████████████████████████████████████│
│ ███████████████████ ███████████ █  ████████ █ ███████ ███████████████████████ █████████████████████│
│███████ ███  █████████████ ████ ███████████ █████████ ███ ██████████████ ████ ███████████████ ██████│
│███████ ███████ ████ █ ██ ████  ██████████████████ ███████████████ ████████████████████████ ████████│
│████  █████  ████████████ ███ ███████████ ████████████████  ██████████████ ██████ ██████████████████│
│████ █████████ ██████ █████████ ██ ███████████████████████████ ███████████████████ ███ ████████████ │
│██ ███████████ ███████████████████████████ █ ██████████████████████ ████████████ █████████ ████ ██ █│
│████████ ███████████████ ███████████████████████ █ █ ███████████ ████ ████████████████████████ ██ ██│
│██████████████████████ ██ █████████ █ ████ ███████████████████████ ███ ██ ████ ████ ████████████ ███│
│████████████████████ ██ █ ██ ████████ ███████████████████ █████████████████████ ███████████████ ██ █│
│  ████ ███████████████ █████ ████████ ████ █ ██████  ████ █████████████████████████████████ ██ ██ █ │
│███ ██████ ██████████████████████████  ███████████████ ██████████████ ███ ███ ████████ █████████████│
│████████ ██████ ████████  ███████ ███████ ██ ███████████████████ ████████████████████ ██████████████│
│█ ████ ████████ ███████ ████████████████████████████████████████████████████████  █████████ ██████  │
│ ███████████████████████████████████ ██████████████████████ ███████████████  ████████████████ ██████│
│ ███ ████████████ ████████ ███████    █  ███████████████████████ ███████████████████████████████████│
│█ ████████ ██ ███████ ██ ███ ███████████████████████   █  █████████████████ ████████ ██████████ ████│
│██████ █████████ ██████ ██ ███ █████████████ ████████ ███████ ██████████ ███████████████████████████│
│██ ███ ██████  ██ ████████ █████████ ███ ██████ ██████████████████████ █ ██████ █ ████████████ ███ █│
│ ███████ █████████████ █████ ██████████████ █ █████████ ██████ █████ █████████████████ ██ ██ ███ █ █│
│████████  █████████████ ██████ ██ █████ █████████████████████████████ ██████████ ███████████████████│
│██████████████ ██████████████████████ ███ ██ ███████████████████████ █████ █████ ██ ██████████████ █│
│███████ ███ █████████████████████ █████ ██ ███████████████████████ ████  ███████████████████████████│
│█████████████████████████████  ██ █████████ ████████ ████████ ████████ ████ █ ██████████  ██████████│
│███████████████████ █ ███████████████████ ██ ██ ████████████████████ █████████████ ██████  █████████│
│████ ██████████████████ ████████████████████████  ██████ ███ █ ███████ █ ███████████ █ █████████████│
│█ █████ ████████████████████████████████████████████████ ████ ████ █ ███████████████████████████████│
│██████████████████ ████████████████████████ ███ ████ ██████████████████████████████████████████████ │
│█ █████  ███ █████████ ███████████████ ███████████████████████ ████████████ █████████████████ ██████│
│██ █ ████████████████████ ███████  ███  ███  ████████ ██████████ ████ ███████████████████████ ██████│
│███████ ████████ ████████ ███ ██████████ ██████████ ███████████████████████ ████████████████████ ███│
│███████████████ █ █████ ███████ ███  ████████████████████████████████ ██ ████████ ███ █ ███████████ │
│██ ████ ████████ ██████████ █   ███  ████████████████ █ ██ ██████ ███ ███████ █████████████████████ │
│██████████████ █████ █████████████ ████████████ ███████████████████ ████████████████████████████████│
│██████████ ██ ████████████████████████ █ █████ ██████ ███████   █ ████████ ██ █████ ██ █████████████│
│████████ ████████████████████████████ █████████████████ █████ ███████████████████ █████ ███████ ████│
│███ █████████████████  ██ ████ ███████ ██████████████ ██████ ███████████████ ███████ █████ █████████│
│███ ███ ███ ████ ████ ████████████████████████████ ████ ████████ ██████████ ██████████████ ██ █  ███│
│████ ██████████████ ███████████ █ ███  ███████████ ██ █ ████ ████ █ █████ ██████ ████████████ ███ ██│
│██████ ███████████ █ █████████████████ ████████ ███████ ███████████████ ███ █████████ █ █████████ ██│
│██████████████████  ██████ ██████████████████████ ██ ██████████████████  ███ ██ ██████████ █████████│
│ ███ █████████ ███ █████████████████████████ █████████████████████████ █ █████████████████████ ████ │
│█████████ █████████████ ████ ██████████████████████ █ ███████  ███████████ ███ █████████████ ███████│
│██████████████████████ █████████████████████ ███████████████████████████████████████ ███ ███████████│
│████████████████████████ █ █  ████ █ ████████████  ███ ████████████████████ █ ███████ ███████████ ██│
│████████████████ █ ██████████████ ██████████████▽  ███ █ ██████ ██████████████████ ███  █ ██████████│
│██ █████ █████████████████████████████████ █ ███  ██████████ ████████   █ ████████ ███████ █████ ███│
│███████ ████████████ ████████████████████████ ███████ ███ ██████ █████████████████████████ █████████│
│████████ █ █████████  █████████ ████████████████████████████████████████████ ██████ ████████ ███ ███│
│████████████ █████████████████  █████ █████████████ █████████ ██ ███ ███████████████████████████████│
│██ ██████████████████ ███████ ████████████████████ ██████████████████████ █████████ █████ █ ████  ██│
│████ █████ ███ █ ████ ███ ███   ██████ ████████████████████████████████████████ ██████  █ █ █ ██████│
│█ ███████████████████████████████████████████████████ ████ █ ███████ ███████████████████ █████ ███ █│
│█████████████████ █████████████ ███ █████████████████████████████████████ ██████████████████████████│
│███████████ █ ████████████████████████████ ███████████████ █████████████████ ██ █████  █████████████│
│███████████ ████ ████████████████ ████████████████████████ █████ ██ █████ ███████████████████ ██████│
│█ █ ███ ██████████ ██████████ ██████████████████ ████████   ██████ ███ ██  ██████ ███ ██████████████│
│███████████ █████ █ ████████████████  █████████████████████████ ████ ███████  ████████████ █████████│
│█ █████ ███████ ██████████████████████████████████ ██████ █████ █████ ██████████ ██████ ████ ███████│
│██████  █████ ████████████████████ ██████ ██ ███████████████████████████████ ████████████████████ ██│
│██████    ████ █ ██████████ ████ ██ ███ ███████████████ █████ ██████████ ███ ██████ ██ ██████ ██████│
│████████████████████ ██████████████████████████████████ ██████████████ ███████████████████ ██ █████ │
│████ ███ █████████ ██ ██ ███████████████████████████ ███████████████████████████████████████ ███████│
│██ ████████ █████ ████ ██████ ██████  ██████ ████████████████████████████ ████ ████ ████████████████│
│ ████ ███  █ █████ ██████████████ █ ████ █████████████████████████████  ███████████ ████████████ ███│
│███████ ██ ██████████████████████████████████████ █████ ███████████████████████████████ █████ ██████│
│████████████ ███ █████████████████████████ ███ ██████████████████████ ██████████████ █████████ █████│
│ ██ ███ ████ ███████████ █████████ ███ ██████████████████████ ████████████████████████ ███████████ █│
│█████████████████████████████████████ █████████ ████████ ███ ██████ ████████████  ██████ ███████████│
│████  ███████ ███ █ ████ ███ ████ ████████████ █████ ██ ███ ███████████ █████████ ███████ █████ █ ██│
│███████ ███████ █████████████████████████ █████████████████ █████████████████████ █████ ███ ████████│
│█████████ ██ ██████████  ██ ██ █████████████ █ █ ███████ ██████████████████████ █████ ██ ████ ██████│
│██████████ ████ █████████  ███████████████████ ███████  ████████ █████ ███████ █████████████████████│
│████████████ █████████████████████ ██████ ████████████ ██████████████████████████████████████ ███ ██│
│██████████████████████████████████████████ ████ ██ ████████████████████████ ████████  ██████████████│
│███████ █████████████████████ ███████████ ████ █████████████████████████████████ ███████ ████ ███ █ │
│███████████ ███████████████ ████████████████████ ███████  █ ███ ████████ ███████████ ███████████████│
│██ ███████████████ ██████████ ██████ ███████████████████████ ██████████████ ████████████████████████│
│█████████  █████ ██ █ ████████████ ████████████████  █ █████████████ █████████████ ██ █ ██████ █████│
│ ██ ██ ███████████ ████ ████████ ███████████████ █████████████████ ████████████████████████████ ████│
│█ ████ █████████████████████ ███████████████ ██████████████ █████████ ███████████████ ██ ███ ██ ████│
│█████ ██████████████████████████████████████ ████ ██████  ███ █ ████████████████████ ███████ █████ █│
│██ █████████ ████ █  █  ███████ ██ ████████████████████████ ██████████████ ███████ █ ███ ███████████│
│███████████████ ███ ███████████████████████████████████████████ ██████████████████████████ ██ ████ █│
│████ ██████████████████████ ███████████████ █████████████████████████████   █ ████████████████ █████│
│██ ██████ ██ ███ ██████ ████████ ████ ███████████████ █ ██████ ████████████ ████████████████████████│
│███████████████  ███████████ █████ ██████████████████ ██████  █ ███ ███████████████████ █████████ ██│
│███████████ █████ ███████████████████████████████ ██████████████████ █ ███ █████████████████████████│
│█████████████████ ███████████████████████████ ████████ █ █ ██████████████████ ██████████████████████│
│██████ ███ ████ █  ██ ██████████████████████████████ ██████████ █████████████████████ █████  █████ █│
│██████ ██████████████████████████████████████████████████ █████████ ██ ███████████  ███ ██ ██████ █ │
│████ █████████  ███████████████ ████████████████████ ███████ ██████ ██████████████████████████████ █│
│█████████████ ██████ ███████████ ████  ██████████████████ ███████████ ████████████ ███ ███████████ █│
│█ █████████████████ ████████ ██ █████████████████████ █████████████████████ ████████████████████████│
│██████ ███████ ██████████████████ ████████████ ███████████████████ █████ ███████████████████████████│
└────────────────────────────────────────────────────────────────────────────────────────────────────┘
