2 9 9 9 9 9 9 9 9 3
6 0 0 0 0 0 0 0 0 6
6 0 0 1 0 0 0 0 0 6
6 0 0 0 0 0 0 0 0 6
6 0 0 0 0 0 0 0 0 6
6 0 0 21 0 0 0 0 0 6
6 0 0 0 0 0 0 0 0 6
6 0 0 0 0 0 0 0 0 6
6 0 0 0 0 0 0 0 0 6
4 9 9 9 9 9 9 9 9 5
